2 2 2 2 2 2 2 2 2 2 2 2 2 2 2 2 2 2 2 2 2
2 2 2 2 2 2 2 2 2 2 2 2 2 2 2 2 2 2 2 2 2
2 9 1 11 2 9 1 10 1 1 1 1 1 1 1 10 1 10 1 11 2
2 0 2 7 1 5 2 0 2 2 2 2 2 2 2 0 2 0 2 0 2
2 0 2 3 1 11 2 7 1 1 10 1 1 1 1 4 1 6 1 8 2
2 0 2 2 2 0 2 0 2 2 0 2 2 2 2 2 2 0 2 0 2
2 0 2 9 1 5 2 7 1 10 4 1 1 11 2 9 1 8 2 0 2
2 0 2 0 2 2 2 0 2 0 2 2 2 0 2 0 2 0 2 0 2
2 7 1 5 2 9 1 5 2 0 2 2 2 7 1 5 2 7 1 8 2
2 0 2 2 2 0 2 2 2 0 2 2 2 0 2 2 2 0 2 0 2
2 7 1 11 2 7 1 11 2 0 2 2 2 7 1 11 2 7 1 8 2
2 0 2 0 2 0 2 0 2 0 2 2 2 0 2 0 2 0 2 0 2
2 0 2 3 1 8 2 7 1 4 10 1 1 5 2 3 1 8 2 0 2
2 0 2 2 2 0 2 0 2 2 0 2 2 2 2 2 2 0 2 0 2
2 0 2 9 1 4 1 6 1 1 4 1 1 1 1 10 1 6 1 8 2
2 0 2 0 2 2 2 0 2 2 2 2 2 2 2 0 2 0 2 0 2
2 0 2 7 1 11 2 0 2 2 2 2 2 2 2 0 2 0 2 0 2
2 3 1 5 2 3 1 5 2 2 2 2 2 2 2 3 1 4 1 5 2
2 2 2 2 2 2 2 2 2 2 2 2 2 2 2 2 2 2 2 2 2